0000000000000000000000000000000000000m000000000000000m00m0000000000000000000000000000000000000000000
0I0I0I0I0I0I0I0I0I0I0I0I0I0I0I0I0I0I0I0I0I0I0I0I0I0I0I0I0I0I0I0I0I0I0I0I0I0I0I0I0I0I0I0I0I0I0I0I0I0I
00000000000000000000m000000000000000000M000000000000000000000000000000000000000000000000000000000000
0I0I0I0I0I0I0I0I0IMI0I0I0I0I0I0I0I0I0I0I0ImI0I0I0I0I0I0I0I0I0I0I0I0I0I0I0I0I0I0I0I0I0I0I0I0I0I0I0I0I
0000000000000000000000000000000000000M00000000000000000000000000000000000000000000000000000000000000
0I0I0I0I0I0I0I0I0I0I0I0I0I0I0I0I0I0I0I0I0I0I0I0I0I0I0I0I0I0I0I0I0I0I0IMI0I0I0I0I0I0I0I0I0I0I0I0I0I0I
00000000000000000000000000000000000000000000000000000000000000000000000000000000000m000000000000m000
0I0I0I0I0IMI0I0I0I0I0I0I0I0I0I0I0I0I0I0I0ImI0I0I0I0I0I0I0I0I0ImI0I0I0I0I0I0I0I0I0I0I0I0I0I0I0I0I0I0I
00000M00000000000000000M0m0M000m00000000000000000000000000000000M000000M0000000000000000000000000000
0I0I0I0I0I0I0I0I0I0I0I0I0I0I0I0I0I0ImI0I0I0I0I0I0I0I0I0I0I0I0I0I0I0I0I0I0I0I0I0I0I0I0I0I0I0I0I0I0I0I
00mm00000M0000M00000000000000000m00000M0000000m000000M0m00000000000000m00000000000000000000000000000
0I0I0I0I0I0I0I0I0I0I0I0I0I0IMI0I0I0I0I0I0I0I0I0I0I0I0I0I0I0I0I0I0I0I0I0I0I0I0I0I0I0I0I0I0I0I0I0I0I0I
m00000m000000000000000000000000000000m000000000000000M000000000000000000000000000000000000M000000000
0I0I0I0I0I0I0M00000000000000m000000000000000000000000000Mm00000000000000000000000M0000000I0I0I0I0I0I
00000000m00000000m000000000000000000000M0000000000000000000000000000000000000000000m0000000000000000
0ImI0I0I0I0I000000000000000000000000000000000000000000m00000000000000000000M0000000000000I0I0I0I0I0I
000000000000000000000000000000000000000000000000000000000000000000000000000M000000mm0mM0000000000000
0I0I0I0I0I0I0000000000000m000000000000000000000000000000000000000000000000000000000000000I0I0I0I0ImI
m0000000000000000m00000000000M00000000000000m000000M00000000000000000000000000000000000000M000000000
0I0I0I0I0I0I0000000000M000000000000000000m00000000000000M00000000000000000000000000000000I0I0I0I0I0I
000M0000000000000000000000M000000000000000000000000000000000000000000000000000000000000000000m000000
0I0I0ImI0I0I0000000000000000M0000000mM000000000000000000000000000000000000000000000000000I0I0I0I0IMI
0m000000000000m00000000000000000000000m0000000000000000000000000000M00m00000000000000000000000000000
0I0I0I0I0I0I000M00m00000000M0000000000000000000000000M000000M000m0000m0000000000000000000I0I0I0I0I0I
0000000000000000000000000000000000000000000000000M000000000000M00000m0000000000000000000000000000000
0I0I0I0I0I0I00000000000000000000000000000000000000000000000000000000M00000000000000000000I0I0I0I0I0I
000000000000000000000000000M00000000000000000000000000MM000000000000000000000000M0000000000000000000
0I0I0I0I0I0I000000000000000000M0000M000000000000000000000000000000000000m00000000000m0000I0I0I0IMI0I
000000000000000000000000000000000000000000000000000000000000000M0000000000000000000000000000000000M0
0ImI0I0I0I0I0000000000000000000000000000000000000m000000000000000000000000000000000000000I0I0I0IMI0I
0000000000000000m0000000000000000000000000000000000000000000000000000000000000000000000000Mm00000000
0I0I0I0I0I0I000000000000000000000000000000000000000000m000000000000000000000000M000000000IMI0I0I0I0I
00000000000000000000000000000000000000000000000000000000000000000000000000000m000m00000000000000000M
0I0I0ImI0I0I00000000000000000000000000000000000000000000000000000000000M00000000000M00000I0I0I0I0I0I
000m000000000000000000000000000000m0000M000000m0000000000m00000000000000000000000000000000m000000000
0I0I0I0I0I0I00000000000000000000000000m0000000000000000000000000000000000000000M000000000I0I0I0I0I0I
0000000m00000000000000000000000000000M0000000000000000000000M0000000000000m000000000m000000000000000
0I0I0I0I0I0I0000000000000000000000000000000000000000000000000000000000000000000000M000000I0I0I0ImI0I
m000000000000M000000000000000M0000000000000000000000000000000000000M00000000000000000000000000000000
0I0I0I0I0I0I00000M0000000000000000000M0000000000m0000000000000000000000000000000000000000I0I0I0I0I0I
0000000000000000000000000000M0000000000000000000m000000000000000000000000000000000000000000000m00000
0I0I0I0I0I0I00000000000000000000000000000000000000000000000000000000000000000000000000000I0I0I0I0I0I
000000000000000000000000000000000000000000000000000000000000000000000000000000000000000000m0000m0000
0I0I0I0I0I0I000000000000000000000000000000000000000000000000000000000000000m000m00m000000I0I0I0I0I0I
00000000000000000000000000000m000000000000000000000000000000000000000000000000000M000000000000000000
0I0I0I0I0I0I00000m0000000000000000000000000000000000000000M0M0000000M00000000000000m00000ImI0I0I0I0I
00000000000000000000000000000000000000000000000000000000M0000000000000000000m00mM0000000mM0000000000
0I0I0I0I0I0I0000000000000m000000000000000000000000000000000000000000000000000000000000000I0I0I0I0I0I
00000000000000000000000M0000000M00000000m000m0000000000000000m0000000000000000M000000000000000000000
0I0I0I0ImI0I00000000000000000000000000000000000m0m00000000000000000000000000000000000000MI0IMIMI0I0I
000000000000000M00000m00000000m000000000M00000000m0000000000000000000000000000000000000000000M000000
0I0I0I0I0I0I000000000000000000M000000000000000000000000000000000000000000000m0000m0000000I0I0I0I0I0I
000000000000000000000M0000000000000000000000000000000000m000000000m000000000000000000000000000000000
0I0I0I0I0I0I000000000000000000000000000000000m0000000000000000M000000000000M0000000000000I0I0I0I0I0I
000000000000000000000000000000m000000000m0000000000000M0000M0000000000000000000000000000000000000000
0I0I0I0I0I0I000000000000M000000000000000000000000000000000000m000000000000000000000000000I0I0I0I0I0I
000000000000000000000000000000000000000000000m000000000000000000000M0000000000000000000000m000000000
0I0I0I0I0I0I0000000000000000000000000m00000000000000000000000m0000m00000m000000000000000MI0I0I0I0I0I
00m0M00000000000000000000000000000000M000m000000M00000000m00000000000000m000000M00000000000000000m00
0I0I0I0ImI0I000000000000000000000000000000000000000000000000000000000000000000000000M0000I0I0I0I0I0I
000000000M000000M000000000000000000000000000000000000m000000000000000000000000000m000000000000000000
0I0I0I0I0I0I0000000000000000000000000000000M00000M00000000000000000000000000000000000m000I0I0I0I0I0I
00000000000000000000000000000000000000m000000000000000m00000000000000m00000000000000mm00000000000m00
0I0I0I0I0I0I0000000000000000000000000m000000000000000000M0M000000000000000000000000000000I0I0I0I0I0I
000000000000000000000000000000000000000000000000000000000M000000000m0000000000000000000000M000M00000
0I0I0I0I0I0I000000000000000000000000m000000M0000M0000000000000000000m00000000000000000000I0I0I0I0I0I
000m0000000000000M000000000000000000000M000000000000000000000000000000000000000000000000000000000M00
0IMI0I0I0I0I0000000000000000M0000000000000000000000000000000000000000000000000m0000000000I0I0I0ImI0I
000000000000000000000000000000000000000000000m00000000000000000000000000000000000000000M000000000000
0I0I0I0I0I0I00000000000000000000000000000000000000000000000000000000000000000000000000000I0I0I0I0I0I
00000000000000000000000000000000M000000000000000000000000000000000M0000000000000000000000m0000000000
MI0I0I0I0I0I0m0000m00000000000000000000000000000000000000000000m000000mM00000000000000000I0I0I0I0I0I
00000000000000mm000000000000000000000000000000mM0000000000000M00000000000000000000000000000000000000
0I0I0IMI0I0I000000000000000000000000000000000000000000000000000000m0000000000000000000000I0I0I0ImI0I
M000000000000000000000000000000000000000000000000000000m00000000000000000000000000000000M00000000000
0I0I0I0I0I0I0000000000000000m0000000000000000000000000000000m0Mm0000000M00000000000m00000I0I0I0I0I0I
00000000000000000M0000000000000000000000000000000000000000M0000000000000000000000000000000M00000M000
0I0I0I0I0I0I0000000000000000m0000000000000000000000000000000000000000000M0000mM0000000000I0I0I0I0IMI
0000000000000M00000M00000000000000000000000000000000000000M00000000000000000000000000000000000000000
0I0I0I0I0I0I00M000000000000000000000000000000000m0000000000000000000000000000000000000000I0I0I0I0I0I
00000000000000000000000000m00000000000000000000M0000000000000000000000000000000000M00000000000000000
0I0I0I0IMI0I00000000000000000000m000000000000000000000000000000000000000000M000M000000000I0I0I0I0I0I
00000000000M0000000000000000000000M000M00000000000000000000000000000000000000M00000000000000M0000000
MI0I0I0I0I0I00000000000000000M0000000000000000000000m00000000000000000m00000000000000M000I0I0I0I0I0I
000000000000000000000000000000000000000000000000M00000000M000000000000000000000m000m0000000000000000
0I0I0I0I0I0IM00000000000000000000000M000000000000MM00000000000000000000m0000000m000000000I0I0I0I0I0I
00000000000M000000000000000000m00m00000000000000000000000000000m0000m0000000m00000m000000M0000000000
0I0I0I0IMI0Im0000000000000000m00000000000000000000000000000000000000000000000000000000000I0I0I0I0I0I
0000M0000000000000M00000000000000000000000000000000000000000000000M000000000000000M00000000000000000
0I0IMI0I0I0I0I0I0I0I0I0I0I0I0I0I0I0I0I0I0I0I0I0I0I0I0I0I0I0I0I0I0I0I0I0I0I0I0I0I0I0I0I0I0I0I0I0I0IMI
0000000000000000000000000000000000000000000000000000000000000000000000000000m00000000000000000000000
0IMI0I0I0I0I0I0I0I0I0I0I0I0I0ImI0I0I0ImI0I0I0I0I0I0I0I0I0I0I0IMI0I0I0I0I0I0I0I0I0I0I0I0I0I0I0I0I0I0I
0000000000000000000000m00000000000000000000m00M0000000000000000000000000m000000000000000000000000000
0I0I0I0I0I0I0I0I0I0I0I0I0ImI0I0I0I0I0I0I0I0I0I0I0I0I0I0I0I0I0I0I0I0I0I0I0I0I0I0I0I0I0I0I0I0I0I0I0I0I
000m0M000000000000000000000M0000000m000000m000000000000000000000000000000000000000m00000000000000000
0I0I0I0I0I0I0I0I0I0I0I0I0I0I0I0I0I0I0I0I0I0I0I0I0I0ImI0I0I0I0I0I0I0I0I0I0I0I0I0I0I0I0I0I0I0I0I0I0I0I
00000000m00m0000m00000000000000000000000000000000000000m0M000000000000000000000m000000000m00000000M0
0I0I0I0I0I0I0IMI0I0I0I0I0I0I0I0I0I0I0I0I0I0I0I0I0I0I0I0I0I0I0I0I0I0I0I0I0I0I0I0I0I0I0I0I0I0I0I0I0I0I
0m000000000000000000000000000000000000000000000000000000m0000000000000000000000000000000000000000000
0I0I0I0I0ImI0I0I0I0IMI0I0I0I0I0I0I0I0I0I0I0I0I0I0I0I0I0I0I0I0I0I0I0I0I0I0I0I0IMI0I0I0I0I0I0I0I0I0I0I
