0000000000000000000000000000000000000000000000000000000M00000000000000000000000000000m00000000000000
0I0I0I0I0I0I0I0I0I0I0I0I0I0I0I0I0I0I0I0I0I0I0I0I0I0I0I0I0I0I0I0I0I0I0I0I0I0I0I0I0I0I0I0I0I0I0I0I0I0I
0000000000000000000M00000000000000000000000000000000000000000000000000000000000000000000000000000000
0I0I0I0I0I0I0I0I0I0I0I0I0I0I0I0ImI0I0I0I0I0I0I0I0I0I0I0I0I0I0I0I0I0I0I0I0I0I0I0ImI0I0I0I0I0I0I0I0I0I
0000000000000000000000000000000000000000000000000000000000000000000000000000000M000000000000000000m0
0I0I0I0I0I0I0I0I0I0I0I0I0I0I0I0I0I0I0I0I0I0I0I0I0I0I0I0I0I0I0I0I0I0I0I0I0I0I0I0I0I0I0I0I0I0I0I0I0I0I
0000000M0000000000000000000000000000000000000000000000000000000000000000000000000000m000000000000000
0I0I0I0I0I0I0I0I0I0I0I0I0I0I0I0I0I0I0I0I0I0I0I0I0I0I0I0I0I0I0I0I0I0ImI0I0I0I0I0I0I0I0I0I0I0I0I0I0I0I
00M00000000000000000000000000000000000000m000000000000000000000000000000000000000000000000000000000M
0I0I0I0I0I0I0I0I0I0I0I0I0I0I0I0I0I0I0I0I0I0I0I0I0I0I0I0I0I0I0I0I0I0I0I0I0I0I0I0I0I0I0I0I0I0I0I0I0I0I
0000000000000000000000000000000m000000000000000000000000000000000000000000000000000000000000000M0000
0I0I0I0I0I0I0I0I0I0I0I0I0I0I0I0I0I0I0I0I0I0I0I0I0I0I0I0I0I0I0I0I0I0I0I0I0I0I0I0I0I0I0I0I0I0I0I0I0I0I
000000000M00000000000000000000000000000000000000000000000000000000m000000000M000000000000000000m0000
0I0I0I0I0I0I00000000000000000000000000000000000000000000000000000000000000000000000000000I0I0I0I0I0I
0000000m00000000000000000000000M00000000000000000000000000000000000000000000000000000000000000000000
0I0I0I0I0I0I00000000000000000000000000000000000000000000000000000000000000000000000000000I0I0I0I0I0I
0000000000000000000000000000000000000000000000000000000000000000000000000000000000000000000000000000
0I0I0I0I0I0I00000000000000000000000000000000000000000000M000000000000000m0000000000000000I0I0I0I0I0I
000000000000000000000000000000000000000000m000000000000000000000000000000000000000000000000000000000
0I0I0I0I0I0I00000000000000000000000000000000000000000M00000000000000000m00000000000000000I0I0I0I0I0I
0000000000m00000000000000000000000000000000000000000000000000000000000000000000000000000000000000000
0I0I0I0I0IMI00000000000000000000000000000000000000000000000000000000000000000000000000000I0I0ImI0I0I
000m000000000000000000000000000000000000000000000000000000000000000000000000000000000000000000000000
0I0I0I0I0I0I000000M0000000000000000000000000000000000000000000000000000000000000000M00000I0I0I0I0I0I
0000000000000000000000000000000000000000000000000000000000000000000000000000000000000000000000000000
0I0I0I0I0I0I00000000000000000000000000000000000000000000000000000000000000000000000000000I0I0I0I0I0I
00000000000000000000m0000000000000000000000000000000000000000000000000000000000000m0000m000m00000000
0I0I0I0I0I0I00000000000000000000000000000000000000000000000000000000000000000000000000000I0I0I0I0I0I
00000000000000000000000000000000000000000000000000000000000000000000000m0000000000000000000000000000
0I0I0I0I0I0I0000000000000M00000000000000000000000000000000000000000000000000M000000000000I0I0I0I0I0I
00000000000000000000000000000000M0000000000000000000000000000000000000000000000000000000000000000000
0I0I0I0I0I0I00000000000000000000000000000000000000000000000000000000000000000000000000000I0I0I0I0I0I
000000000000M0000000000000000000000000000m0000000000000000000000000000000000000000000000000000000000
0I0I0I0I0I0I00000000000000000m00000000000000000000000000000000000000000000000000000000000I0I0I0I0I0I
00000000000000000000000M000000000000000000000000000000000000000000000000000000000000000000M000000000
0I0I0I0I0I0I00000000000000000000000000000000000000000000000000000000000M00000000000000000I0I0I0I0I0I
0000000m00000000000000000000000000000000000000000000000000m00000000000000000000000000000000000000000
0I0ImI0I0I0I00000000000000000000000000000000000000000000000000000000000000000000000000000I0I0I0I0I0I
000000000000000000000000000000000000000000000000000m000000000M00000000000000000000000000000000000000
0I0I0I0I0I0I00000000000000000000000000000000000000000000000000000000000000000M00000000000I0I0I0I0I0I
0000000000000000M00000000000000000000000000000000000000000000000000000000000000000000000000000000000
0I0I0I0I0I0I00000000000000000000000000000000000000000000000000000000000000000000000000000I0I0I0I0I0I
0000000000000000000000000000000000000000000000000000000000000000000000000000000000000000000000000000
0I0I0I0I0I0I0000000000000000000000000000000000000000000000000000000000000m000000000000000I0I0I0I0I0I
0000000000000000000000000000000000000000000000000000000000000000000000000000000000000000000000000000
0I0I0I0I0I0I0000000000000000000000000000000000000m000000000000000000000000000000000000000I0I0I0I0I0I
0000000000000000000000000000000000000000000000000000000000000000000000000000000000000000000000000000
0I0I0I0I0I0I000000000000000000000000000000000000000M0000000000000000000000000000000000000I0I0I0I0I0I
000000000000000000000000000000000000000000000000000000000000000000000000000000000m000000000000000000
0I0I0I0I0I0I00000000000000000000000000000000000000000000000000000000000000000000000000000I0I0I0I0I0I
0000000000000000000000000M0000000000000000000000000000000000000000000000000000000000000000M000000000
0I0I0I0I0IMI0000000000000000000M000000000000000000000000000000000000000000000000000000000I0I0I0IMI0I
0000000000000m00000M00000000000000000000000000000000000000000000000000000000000000000000000000000M00
0I0I0I0I0I0I0000000M000000000000000000000000000000000000000000000000000000000000000000000I0I0I0I0I0I
000000000000000000000000000000000m000000000000000000000000000000000000000000000000000000000000000000
0I0I0I0I0I0I000000000000000000000000000000000000000000000000m000000000000000000000M000000ImI0I0I0I0I
00000000000000000000000000000000000000000000000000000000000000000m0000000000000000000000000000000000
0I0I0I0I0I0I00000000000000000000000000000000000000000000000000000000000000000000000000000I0I0I0I0I0I
0000000000000000000000000000000000000000m00000000000000000000000000000000000000000000000000000000000
0I0I0I0I0I0I00000000000000000000000000M000000000000000000000m0000000000000000m00000000000I0I0I0I0I0I
0000000000000000000000000000000000000000000000000000000000000000000000000000000000000000000000000000
0I0I0I0I0I0I00000000000000000000000000000000000000000000000000000000000000000000000000000I0I0I0I0I0I
0000000000000000000000000000000000000000000000000000000000000000000000000000000000000000000000000000
0I0I0I0I0I0I00000000000000000000000000000000000000000000000000000000000000000000000000000I0I0I0IMI0I
0000000000000000000000000000000000000000000000000000000000000000000000000000000000000000000000000000
0I0I0I0I0I0I00000000000000000000000000000000000000000000000000000000000000000000000000000I0I0I0I0I0I
0000000000000000000000000000000000000m00000000000000000000M00000000000000000000000000000000000000000
0I0I0I0I0I0I0000000000000000000000000000000000000000000000000000000000000000000M000000000I0I0I0I0I0I
00000000000000000000000000000000000000000000000000000000000000000000m0000000000000000000000000000000
0I0I0I0I0I0I00000000000000000000000000000000000000000000000000000000000000000000000000000I0I0I0I0IMI
0000000000000000000000000000000000000000000000000000000000000000000000000000000000000000000000000000
0I0I0I0I0I0I00000000000000000000000000000000000000000000000000000000000000000000000000000I0I0I0I0I0I
000000000000000000000000000M000000000M000000000000000000000000000000000000000000000000M0000000000000
0I0I0I0I0I0I00000m00000000000000000000000000000000000000000000000M0000000000m000000000000I0I0I0I0I0I
0000000000000000000000000000000000000000000000000000000000000000000000000000000000M00000000000000000
0I0I0I0I0I0I000000000000000000M0000000000000m00000000000000000000000000000000000000M00000I0I0I0I0I0I
000000000000000000000000000000000000000m000000000000000000000000000000000000000000000000000000000000
0I0I0I0I0I0I0000000000000000000000000000000000000000000000000000000000000000000000000M000I0I0I0I0I0I
00M0000000000000000000000000M00000000000000000000000000000000000000000000000000000000000000000000000
0I0I0I0I0I0I00000000000000000000000000000000000000000000000000000000000000000000000000000I0I0I0I0I0I
0000000000000000000000000000000000000000000000000000000000000000M00000000M00000000000000000000000000
0I0I0I0I0I0IM0000000000000000000000000000000000000000000000000000000000000000000000000000I0I0I0I0I0I
0000000000000000000000000000000000000000000000000000000000000000000000000000000000000000000000000000
0I0I0I0I0I0I00000000000000000000000000000000000000000000000000000000000000000000000000000I0I0I0I0I0I
0000000000000000000000000000000000000000000000000000000000000000000000000000000000000000000000000000
0I0I0I0I0I0I00000000000000000000000000000000000000000000000000000000000000000000000000000I0I0I0I0I0I
0000000000000000000000000000000000000000000000000000000000000000000000000000000000000000000000000000
0I0I0I0I0I0I000000000000M00000000000000000000000000000000m0M00000000000000000000000000000I0I0I0I0I0I
00M0000000000000000000000000000000000000000000000000000000000000000000000000000000000000000000000000
0I0I0I0I0I0I0I0I0I0I0I0I0I0I0I0I0I0I0I0I0I0I0I0I0I0I0I0I0I0I0I0I0I0I0I0I0I0I0I0I0I0I0I0IMI0I0I0I0I0I
0000000000000000000000000000000000000000000000000000000000000000000000000000000000000000000000000000
0I0I0I0I0I0I0I0I0I0I0I0I0I0I0I0I0I0I0I0I0I0I0I0I0I0I0I0I0I0I0I0I0I0I0I0I0I0I0I0I0I0I0I0I0I0I0I0I0I0I
000000000000000000000000000000000000000M0000000000000M0000000000000000000000000000000000000000000000
0I0I0I0I0I0I0I0I0I0I0I0I0I0I0I0I0I0I0I0I0I0I0I0I0I0I0I0I0I0I0I0I0I0I0I0I0I0I0I0I0I0I0I0I0I0I0I0I0I0I
00000000000000000000000000000000000000000000000000000000000000000000000000000000000m0000000000000000
0I0I0I0I0I0I0I0I0I0I0I0IMI0I0I0I0I0I0I0I0I0I0I0I0I0I0I0I0I0I0I0I0I0I0I0I0I0I0I0I0I0I0I0I0I0I0I0I0I0I
00000000000000000000000000000000000000000000000000000000000000000M0000000000000000000000000000000000
0I0I0I0I0I0I0I0I0I0I0I0I0I0I0I0I0I0I0I0I0I0I0I0I0I0I0I0I0I0I0I0I0I0I0I0I0I0I0I0I0I0I0I0I0I0I0I0I0I0I
00000000000000000000000000000000000000000000000m0000000000000000000000000000000000000000000000000000
0I0I0I0I0I0I0I0I0I0I0I0I0I0I0I0I0I0I0I0I0I0I0I0I0I0I0I0I0I0I0I0I0I0I0I0I0I0I0I0I0IMI0I0I0I0I0I0I0I0I
