00000000000000000000000000000M0000000000000000000000000000000000000000000000000000000000000000000000
0I0I0I0I0I0I0I0I0I0I0I0I0I0I0I0I0I0I0I0I0I0I0I0I0I0I0I0I0I0I0I0I0I0I0I0ImI0I0I0I0I0I0I0I0I0I0I0I0I0I
0000000000M00000000000000000000000000000000000000000000000000000000000000000000000000000000000000000
0I0I0I0I0I0I0I0I0I0I0I0I0I0I0I0I0I0I0I0I0I0I0I0I0I0I0I0I0I0I0I0I0I0I0I0I0I0I0I0I0I0I0I0I0I0I0I0I0I0I
000000000000000000000000000000000000000000000000000m000000000000000000000000000000000000000000000000
0I0I0I0I0I0I0I0I0I0I0I0I0I0I0I0I0I0I0I0I0I0I0I0I0I0I0I0I0I0I0I0I0I0I0I0I0I0I0I0I0I0I0I0I0I0I0I0I0I0I
0000000000000000000000000000000000000000000000000000000000000000000000000000000000000000000000000000
0I0I0I0I0I0I0I0I0I0I0I0I0I0I0I0I0I0I0I0I0I0I0I0I0I0I0I0I0I0I0I0I0I0I0I0I0I0I0I0I0I0I0ImI0ImI0I0I0I0I
0000000000000000000000000000000000000000000000000000000000000000000000000000000000000000000000000000
0I0I0I0I0I0I0I0I0I0I0I0I0I0I0I0I0I0I0I0I0I0I0I0I0I0I0I0I0I0I0I0I0I0I0I0I0I0I0I0I0I0I0I0I0I0I0I0I0I0I
00000000000000000000000000000000m00000000000000000000000m0000000000000000000000000000000000000m00000
0I0I0I0I0I0I0I0I0I0I0I0I0I0I0I0I0I0I0I0I0I0I0I0I0I0I0I0I0I0I0I0I0I0I0I0I0I0I0I0I0I0I0I0I0I0I0I0I0I0I
00000000000000000000000000000000000000000000000000000m0000000000000000000M00000000000000000000000000
0I0I0I0I0I0I0I0I0I0I0I0I0I0I0I0I0I0I0I0I0I0I0I0I0I0I0I0I0I0I0I0I0I0I0I0I0I0I0I0I0I0I0I0I0I0I0I0I0I0I
0000000000000000000000000000000000000000000000000000000000000000000000000000000000000000000000000000
0I0I0I0ImI0I0I0I0I0I0I0I0I0I0I0I0I0I0I0I0I0I0I0I0I0I0I0I0I0I0I0I0I0I0I0I0I0I0I0I0I0I0I0I0I0I0I0I0I0I
00000000m00000000000000000M0000000000000000000000000000000000000000000000000000000000000000000000000
0I0I0I0I0I0I0I0I000000000000000000000000000000000000000000000000000000000000000000000I0I0I0I0I0I0I0I
000000000000000000000000000000000000000000000000000000000000000M0000000M0000000000000000000000000000
0I0I0I0I0I0I0I0I000000000000000000000000000000000000000000000000000000000000000000000I0I0I0I0I0I0I0I
0000000000000000000000m00000000000000000000000000000000000000000000000000000000000000000000000000000
0I0I0I0I0I0I0I0I00000000000000000000000000000000000000M0000000000m0000000000000000000I0I0I0I0I0I0I0I
0000000000000000000000000000000000000000000000000000000000000000000000000000000000000000000000000000
0I0I0I0I0I0I0I0I000000000000000000000000000000000000000000000000000000000000000000000I0I0I0I0I0I0I0I
0000000000000000000000000000000000000000000000000000000000000000000m00000000000000000000000000000000
0I0IMI0I0I0I0I0I00000000000000000000000000000000000000000000000M00000000M000000000000I0I0I0I0I0I0I0I
0000000000000000000000000000000000000000000000000000000000000000000000000000000000000000000000000000
0I0I0I0I0I0I0I0I0000m00000000000000000000000000000000000000M0000000000000000000000000I0I0I0I0I0I0I0I
0000000000000000000000000000M00000000000000000000000000000000000000000000000000000000000000000000000
0I0I0I0I0I0I0I0I000000000000000000000000000000000000000000000000000000000000000000000I0I0I0I0I0I0I0I
0000000000000000000000000000000000000000000000000000000000000000000000000000000000000000000000000000
0I0I0I0I0I0I0I0I00000000000000000000000m000000000000000000000000000000000000000000000I0I0I0I0I0I0I0I
000000000000000000M00000000000000m000000000000000000000000000000000000000000000000000000000000000000
0I0I0I0I0I0I0I0I0000000000000000000000000000000000000000m0000000000000000000000000000I0I0I0I0I0I0I0I
0000000000000000000000000000000000000000000000000000000000000000000000000000000000000m00000000000000
0I0I0I0I0I0I0I0I0000000000000000000000000000000000M0000000000000000000000000000000000I0I0I0I0I0I0I0I
00000000000000000000000000000m0000000000000000000000000000000000000000000000000000000000000000000000
0I0I0I0I0I0I0I0I0000000000000m0000000000000000000000000000000000000000000000000000000ImI0I0I0I0I0I0I
0000000000000000000000000000000000000000000000000000000000000000000000000000000000000000000000000000
0I0I0I0I0I0I0I0I000000000000000000000000000000000000000000000000000000000000000000000I0I0I0I0I0I0I0I
0000000000000000000000000000000000000000000000000000000000000000000000000000000000000000000000000000
0I0I0I0I0I0I0I0I000000000000000000000000000000000000000000000000000000000000000000000I0I0I0I0I0I0I0I
M00000000000000000000000000000m0m0000000000000000000000000000000000000000000M0000000000000000000000M
0I0I0I0I0I0I0I0I000000000000000000000000000000000000000000000000000000000000000000000I0I0I0I0I0I0I0I
00000000000000000000000000000000000000M000000000000000000000000000000000000000m00000000000000M000000
0I0I0I0I0I0I0I0I000000000000000000000000000000000000000m00000000000000000000000000000I0I0I0I0I0I0I0I
000000000000000000000000000000000000000000000000000m0000000000000000000M000000000000000000000M000000
0I0I0I0I0I0I0I0I000000000000000000000000000000000000000000000000000000000000000000000I0I0I0I0I0I0I0I
00000000000000000m0000000000000000000000000000000000000000M00000000000000000000000000000000000000000
0I0I0I0I0I0I0I0I00000000000000000000000000000000m0000000000000000000000000000000M0000I0I0I0I0I0I0I0I
0000000000000000000000000000000000000000000000000000000000000000000000000000000000000000000000000000
0I0I0I0I0I0I0I0I000000000000000000000000000000000000000000000000000000000000000000000I0I0I0I0I0I0I0I
00000000000000000000000000000000m0000000000000000000000000000000000000000000000000000000000000000000
0I0I0I0I0I0I0I0I00000000000000000000000000000000000000000000000000000000000000000m000I0I0I0I0I0I0I0I
0000000000000000000000000000000000000000000000000000000000000000000000000000000000000000000000000000
0IMI0I0I0I0I0I0I00000000000000000000000m000000000000000000000000000000000000000000000I0I0I0I0I0I0I0I
00000000000000000000000000000000000000000000000000M0000000000000m00000000000000000000000000000000000
0I0I0I0I0I0I0I0I000000000000000000000000000000000000000000000000000000000000000000000I0I0I0I0I0I0I0I
0000000000000000000000000000000000000M00000000000000000000000000000000000000000000000000000000000000
0I0I0I0I0I0I0I0I000000000000m00000000000000000000000000000000000000000000000000000000I0I0I0I0I0I0I0I
0000000000000000000000000000000000000000000000000000000000000000000000000000000000000000000000000000
0I0I0I0I0I0I0I0I0000000000000000000000000000000000000000000000000M0000000000000000000I0I0I0I0I0I0I0I
0000000000000000000000000000000000000m00000000000000000000000000000000000000000000000000000000000000
0I0I0I0I0I0I0I0I000000000000000000000000000000000000000000000000000000000000000000000I0I0I0I0I0I0I0I
00000000000000000000M0000000000000000000000000000000000000000000000000000000000000000000000000000000
0I0I0I0I0I0I0I0I000000000000000000000000000000000000000000000000000000000000000000000I0I0I0I0I0I0I0I
00000000000000000000000000000000000000000000m0000000000000000000000000000000000000000000000000000000
0I0I0I0I0I0I0I0I000000000000000000000000000000000000000000000000000000000000000000000I0I0I0I0I0I0I0I
00000M00M0000000000000000M00000000000000000000000000000000000000000000000000000000000000000000000000
0I0I0I0I0I0ImI0I000000000000000000000000000000000000000000000000000000000000000000000I0I0I0I0I0I0I0I
0000000000000000000000000000000000000000000000000000000000000000000000000000000000000000000000000000
0I0I0I0I0I0I0I0I0000000000000000000000000M0000000000000000000000000000000000000000000I0I0I0I0I0ImI0I
0000000000000000000000000000000000000000000000000000000000000000000000000000000000000000000000000000
0I0I0I0I0I0I0I0I0000000000000000000m00000000000000000000000000M0000000000000000000000I0I0I0I0I0I0I0I
00000000000000000000000000000000000000000000000000000000000000000000000000000M0000000000000000000000
0I0I0I0I0I0IMI0I000000000000000000000000000000000000000000000000000000000000000000000I0I0I0I0I0I0I0I
0000000000000000000000000000000000000000000000000000000000000000000000000000000000000000000000000000
0I0I0I0I0I0I0I0I000000000000000000000000000000000000000000000000000000000000000000000I0I0I0I0I0I0I0I
0000000000000000000000000000000000000000000000000000000000000000000000000000000000000000000000000000
0I0I0I0I0I0I0I0I000000000000000000000000000000000000000000000000000000000000000000000I0I0I0I0I0I0I0I
00000000000000000000000000M0000000000000000000000000000000000000000000000000000000000000000000000000
0I0I0I0I0I0I0I0I00000000m000000000000000000000000000000000000000000000000000000000000I0I0I0I0I0I0I0I
000000000000000000000000000000000000000000000M00000M000000000000000000000000000000000000000000000000
0I0I0I0I0I0I0I0I000000000000000000000000000000000000000000000000000000000000000000000I0I0I0I0I0I0I0I
0000000000000000000000000000000000000000000000000000000000000000000000000000000000000000000000000000
0I0I0I0I0I0I0I0I0I0I0I0I0I0I0I0I0I0I0I0I0I0I0I0I0I0I0I0IMI0I0I0I0I0I0I0I0I0I0I0I0I0I0I0I0I0I0I0I0I0I
0000M0000000000000000000000000000000000000000000000m000000000000000000000000000000000000000000000000
0I0I0I0I0I0I0I0I0I0I0I0I0I0I0I0I0I0I0I0I0I0I0I0I0I0I0I0I0I0I0I0I0I0I0I0I0I0I0I0I0ImI0I0IMI0I0I0I0I0I
m00000000000000000000000000000000000000000000000000000000000000m000000000000000000000000000000000000
0I0I0I0I0I0I0I0I0I0I0I0I0I0I0I0I0I0I0I0I0I0I0I0I0I0I0I0I0I0I0I0I0I0I0I0I0I0I0I0I0I0I0I0I0I0I0I0I0I0I
0000000000000000000000000000000000000000000000000m00M00000000000000000000000000000000000000000000000
0I0I0I0I0I0I0I0I0I0I0I0I0I0I0I0I0I0I0I0I0I0I0I0I0I0I0I0I0I0I0I0I0I0I0I0I0I0I0I0I0I0I0I0I0I0I0I0I0I0I
0000000000000000000000000000000000000000000000000000000000m0000m000000000000000000000000000000000000
0I0I0I0I0I0I0I0I0I0I0I0I0I0I0I0I0I0I0I0I0I0I0I0I0I0I0I0I0I0I0I0I0I0I0I0I0I0I0I0I0I0I0I0I0I0I0I0I0I0I
000000000000000000000000000000000000000000000000000000000000000000000000000000m000000M00000000000000
0I0I0I0I0I0I0I0I0I0I0I0I0ImI0I0I0I0I0I0I0I0I0I0I0I0I0I0I0I0I0I0ImI0I0I0I0I0I0I0I0I0I0I0I0I0I0I0I0I0I
0000000000000000000000000000000000000000000000000000000000000000000000000000000000000000000000000000
0I0I0I0I0I0I0I0I0I0I0I0I0I0I0I0I0I0I0I0I0I0I0I0I0I0I0I0I0I0I0I0I0I0I0I0I0I0I0I0I0I0I0I0I0I0I0I0I0I0I
00000000000000000000000000000000000000000000000000000000000000000000000000000000000m0000000000000000
0I0I0I0I0I0I0I0I0I0I0I0I0I0I0I0I0I0I0I0I0I0I0I0I0I0IMI0I0I0I0I0I0I0I0I0I0I0I0I0I0I0I0I0I0I0I0I0I0I0I
